10.ox
..o.o.o...o...o
o......o..o...o
..o........o...
o.oo.ooo...o..o
ooooo..o....o.o
.o.......o.o...
o.oo.o.....o.o.
o.......o....o.
o.ooo..o.....o.
....oo..o...o..
