7,og
,,,,,,,,,,,
,,,o,,,,,,,
,,,,,,,,,o,
,,,,,o,,,,,
,,o,,,,,,,,
,,,,,,o,,,,
,,,,,,,,,,,